__________
|........|
|........|
|........###########
|........|         #
|........|         #
----------     ____#____
               |.......|
               |.......|
               |.......|
               |.......|
               ---------
